Year,S/T name,SA4 name,SA3 name,SA2 code,SA2 name,0–4,5–9,10–14,child_count
2021,Victoria,Melbourne - Inner,Brunswick - Coburg,206011106,Brunswick East,488,403,360,1251
2021,Victoria,Melbourne - Inner,Brunswick - Coburg,206011107,Brunswick West,675,623,538,1836
2021,Victoria,Melbourne - Inner,Brunswick - Coburg,206011109,Pascoe Vale South,557,680,689,1926
2021,Victoria,Melbourne - Inner,Brunswick - Coburg,206011495,Brunswick - North,528,451,452,1431
2021,Victoria,Melbourne - Inner,Brunswick - Coburg,206011496,Brunswick - South,520,362,359,1241
2021,Victoria,Melbourne - Inner,Brunswick - Coburg,206011497,Coburg - East,611,544,517,1672
2021,Victoria,Melbourne - Inner,Brunswick - Coburg,206011498,Coburg - West,848,827,786,2461
2021,Victoria,Melbourne - Inner,Darebin - South,206021110,Alphington - Fairfield,468,484,500,1452
2021,Victoria,Melbourne - Inner,Darebin - South,206021112,Thornbury,1005,951,904,2860
2021,Victoria,Melbourne - Inner,Darebin - South,206021499,Northcote - East,722,772,870,2364
2021,Victoria,Melbourne - Inner,Darebin - South,206021500,Northcote - West,465,493,565,1523
2021,Victoria,Melbourne - Inner,Essendon,206031113,Ascot Vale,996,923,811,2730
2021,Victoria,Melbourne - Inner,Essendon,206031115,Flemington,498,394,310,1202
2021,Victoria,Melbourne - Inner,Essendon,206031116,Moonee Ponds,768,773,745,2286
2021,Victoria,Melbourne - Inner,Essendon,206031501,Essendon (West) - Aberfeldie,666,874,1069,2609
2021,Victoria,Melbourne - Inner,Essendon,206031502,Essendon - East,513,608,613,1734
2021,Victoria,Melbourne - Inner,Melbourne City,206041117,Carlton,331,304,287,922
2021,Victoria,Melbourne - Inner,Melbourne City,206041118,Docklands,709,379,162,1250
2021,Victoria,Melbourne - Inner,Melbourne City,206041119,East Melbourne,119,96,91,306
2021,Victoria,Melbourne - Inner,Melbourne City,206041120,Flemington Racecourse,1,0,0,1
2021,Victoria,Melbourne - Inner,Melbourne City,206041121,Kensington (Vic.),632,532,416,1580
2021,Victoria,Melbourne - Inner,Melbourne City,206041124,Parkville,207,154,143,504
2021,Victoria,Melbourne - Inner,Melbourne City,206041125,South Yarra - West,237,164,169,570
2021,Victoria,Melbourne - Inner,Melbourne City,206041127,West Melbourne - Industrial,0,0,0,0
2021,Victoria,Melbourne - Inner,Melbourne City,206041503,Melbourne CBD - East,215,146,114,475
2021,Victoria,Melbourne - Inner,Melbourne City,206041504,Melbourne CBD - North,206,151,147,504
2021,Victoria,Melbourne - Inner,Melbourne City,206041505,Melbourne CBD - West,292,149,118,559
2021,Victoria,Melbourne - Inner,Melbourne City,206041506,North Melbourne,578,601,642,1821
2021,Victoria,Melbourne - Inner,Melbourne City,206041507,Royal Botanic Gardens Victoria,0,0,0,0
2021,Victoria,Melbourne - Inner,Melbourne City,206041508,Southbank (West) - South Wharf,252,145,80,477
2021,Victoria,Melbourne - Inner,Melbourne City,206041509,Southbank - East,455,269,178,902
2021,Victoria,Melbourne - Inner,Melbourne City,206041510,West Melbourne - Residential,252,163,149,564
2021,Victoria,Melbourne - Inner,Port Phillip,206051128,Albert Park,701,724,738,2163
2021,Victoria,Melbourne - Inner,Port Phillip,206051129,Elwood,712,649,644,2005
2021,Victoria,Melbourne - Inner,Port Phillip,206051130,Port Melbourne,825,792,738,2355
2021,Victoria,Melbourne - Inner,Port Phillip,206051134,St Kilda East,755,595,601,1951
2021,Victoria,Melbourne - Inner,Port Phillip,206051511,Port Melbourne Industrial,73,54,44,171
2021,Victoria,Melbourne - Inner,Port Phillip,206051512,South Melbourne,494,453,412,1359
2021,Victoria,Melbourne - Inner,Port Phillip,206051513,St Kilda - Central,374,257,227,858
2021,Victoria,Melbourne - Inner,Port Phillip,206051514,St Kilda - West,409,322,336,1067
2021,Victoria,Melbourne - Inner,Stonnington - West,206061135,Armadale,448,389,383,1220
2021,Victoria,Melbourne - Inner,Stonnington - West,206061136,Prahran - Windsor,703,447,417,1567
2021,Victoria,Melbourne - Inner,Stonnington - West,206061138,Toorak,421,492,564,1477
2021,Victoria,Melbourne - Inner,Stonnington - West,206061515,South Yarra - North,260,157,190,607
2021,Victoria,Melbourne - Inner,Stonnington - West,206061516,South Yarra - South,311,316,211,838
2021,Victoria,Melbourne - Inner,Yarra,206071139,Abbotsford,347,225,181,753
2021,Victoria,Melbourne - Inner,Yarra,206071140,Carlton North - Princes Hill,339,302,280,921
2021,Victoria,Melbourne - Inner,Yarra,206071141,Collingwood,384,288,231,903
2021,Victoria,Melbourne - Inner,Yarra,206071142,Fitzroy,464,343,281,1088
2021,Victoria,Melbourne - Inner,Yarra,206071143,Fitzroy North,532,534,519,1585
2021,Victoria,Melbourne - Inner,Yarra,206071145,Clifton Hill - Alphington,533,523,485,1541
2021,Victoria,Melbourne - Inner,Yarra,206071517,Richmond (South) - Cremorne,712,541,548,1801
2021,Victoria,Melbourne - Inner,Yarra,206071518,Richmond - North,475,412,400,1287
2021,Victoria,Melbourne - Inner East,Boroondara,207011146,Ashburton (Vic.),431,568,619,1618
2021,Victoria,Melbourne - Inner East,Boroondara,207011147,Balwyn,571,922,1162,2655
2021,Victoria,Melbourne - Inner East,Boroondara,207011148,Balwyn North,738,1243,1884,3865
2021,Victoria,Melbourne - Inner East,Boroondara,207011149,Camberwell,915,1193,1397,3505
2021,Victoria,Melbourne - Inner East,Boroondara,207011150,Glen Iris - East,873,1081,1310,3264
2021,Victoria,Melbourne - Inner East,Boroondara,207011152,Hawthorn East,678,823,843,2344
2021,Victoria,Melbourne - Inner East,Boroondara,207011154,Kew East,304,407,480,1191
2021,Victoria,Melbourne - Inner East,Boroondara,207011155,Surrey Hills (West) - Canterbury,572,843,1206,2621
2021,Victoria,Melbourne - Inner East,Boroondara,207011519,Hawthorn - North,429,430,518,1377
2021,Victoria,Melbourne - Inner East,Boroondara,207011520,Hawthorn - South,435,430,534,1399
2021,Victoria,Melbourne - Inner East,Boroondara,207011521,Kew - South,432,523,832,1787
2021,Victoria,Melbourne - Inner East,Boroondara,207011522,Kew - West,542,691,811,2044
2021,Victoria,Melbourne - Inner East,Manningham - West,207021156,Bulleen,510,587,571,1668
2021,Victoria,Melbourne - Inner East,Manningham - West,207021157,Doncaster,1176,1257,1145,3578
2021,Victoria,Melbourne - Inner East,Manningham - West,207021159,Templestowe,751,954,986,2691
2021,Victoria,Melbourne - Inner East,Manningham - West,207021160,Templestowe Lower,708,836,864,2408
2021,Victoria,Melbourne - Inner East,Manningham - West,207021424,Doncaster East - North,649,1004,1003,2656
2021,Victoria,Melbourne - Inner East,Manningham - West,207021425,Doncaster East - South,899,1175,1009,3083
2021,Victoria,Melbourne - Inner East,Whitehorse - West,207031161,Blackburn,1022,1350,1523,3895
2021,Victoria,Melbourne - Inner East,Whitehorse - West,207031162,Blackburn South,550,714,690,1954
2021,Victoria,Melbourne - Inner East,Whitehorse - West,207031163,Box Hill,865,995,1053,2913
2021,Victoria,Melbourne - Inner East,Whitehorse - West,207031164,Box Hill North,924,1062,1176,3162
2021,Victoria,Melbourne - Inner East,Whitehorse - West,207031165,Burwood (Vic.),476,477,586,1539
2021,Victoria,Melbourne - Inner East,Whitehorse - West,207031166,Burwood East,446,552,487,1485
2021,Victoria,Melbourne - Inner East,Whitehorse - West,207031167,Surrey Hills (East) - Mont Albert,437,574,629,1640
2021,Victoria,Melbourne - Inner South,Bayside,208011168,Beaumaris,511,855,1204,2570
2021,Victoria,Melbourne - Inner South,Bayside,208011169,Brighton (Vic.),913,1190,1538,3641
2021,Victoria,Melbourne - Inner South,Bayside,208011170,Brighton East,794,1085,1384,3263
2021,Victoria,Melbourne - Inner South,Bayside,208011171,Highett (West) - Cheltenham,821,903,848,2572
2021,Victoria,Melbourne - Inner South,Bayside,208011172,Hampton,866,1089,1329,3284
2021,Victoria,Melbourne - Inner South,Bayside,208011173,Sandringham - Black Rock,704,925,1163,2792
2021,Victoria,Melbourne - Inner South,Glen Eira,208021174,Bentleigh - McKinnon,1231,1604,1894,4729
2021,Victoria,Melbourne - Inner South,Glen Eira,208021176,Carnegie,930,927,771,2628
2021,Victoria,Melbourne - Inner South,Glen Eira,208021177,Caulfield - North,1339,1356,1373,4068
2021,Victoria,Melbourne - Inner South,Glen Eira,208021178,Caulfield - South,985,1082,1133,3200
2021,Victoria,Melbourne - Inner South,Glen Eira,208021179,Elsternwick,643,680,738,2061
2021,Victoria,Melbourne - Inner South,Glen Eira,208021180,Hughesdale,372,430,409,1211
2021,Victoria,Melbourne - Inner South,Glen Eira,208021181,Murrumbeena,487,540,539,1566
2021,Victoria,Melbourne - Inner South,Glen Eira,208021182,Ormond - Glen Huntly,628,665,762,2055
2021,Victoria,Melbourne - Inner South,Glen Eira,208021426,Bentleigh East - North,911,1260,1456,3627
2021,Victoria,Melbourne - Inner South,Glen Eira,208021427,Bentleigh East - South,865,995,909,2769
2021,Victoria,Melbourne - Inner South,Kingston,208031183,Aspendale Gardens - Waterways,406,580,654,1640
2021,Victoria,Melbourne - Inner South,Kingston,208031184,Braeside,0,0,0,0
2021,Victoria,Melbourne - Inner South,Kingston,208031185,Carrum - Patterson Lakes,734,658,650,2042
2021,Victoria,Melbourne - Inner South,Kingston,208031186,Chelsea - Bonbeach,954,907,768,2629
2021,Victoria,Melbourne - Inner South,Kingston,208031187,Chelsea Heights,351,390,331,1072
2021,Victoria,Melbourne - Inner South,Kingston,208031188,Highett (East) - Cheltenham,1448,1423,1321,4192
2021,Victoria,Melbourne - Inner South,Kingston,208031189,Edithvale - Aspendale,852,973,951,2776
2021,Victoria,Melbourne - Inner South,Kingston,208031190,Mentone,627,740,774,2141
2021,Victoria,Melbourne - Inner South,Kingston,208031191,Moorabbin - Heatherton,578,595,620,1793
2021,Victoria,Melbourne - Inner South,Kingston,208031192,Moorabbin Airport,0,0,0,0
2021,Victoria,Melbourne - Inner South,Kingston,208031193,Mordialloc - Parkdale,1109,1298,1552,3959
2021,Victoria,Melbourne - Inner South,Stonnington - East,208041194,Malvern - Glen Iris,862,964,1217,3043
2021,Victoria,Melbourne - Inner South,Stonnington - East,208041195,Malvern East,1054,1189,1348,3591
2021,Victoria,Melbourne - North East,Banyule,209011196,Bundoora - East,569,524,567,1660
2021,Victoria,Melbourne - North East,Banyule,209011197,Greensborough,1186,1362,1345,3893
2021,Victoria,Melbourne - North East,Banyule,209011198,Heidelberg - Rosanna,883,1117,946,2946
2021,Victoria,Melbourne - North East,Banyule,209011199,Heidelberg West,974,826,686,2486
2021,Victoria,Melbourne - North East,Banyule,209011200,Ivanhoe,566,669,729,1964
2021,Victoria,Melbourne - North East,Banyule,209011201,Ivanhoe East - Eaglemont,309,410,525,1244
2021,Victoria,Melbourne - North East,Banyule,209011202,Montmorency - Briar Hill,1006,1137,1092,3235
2021,Victoria,Melbourne - North East,Banyule,209011203,Viewbank - Yallambie,1142,1293,1283,3718
2021,Victoria,Melbourne - North East,Banyule,209011204,Watsonia,611,592,539,1742
2021,Victoria,Melbourne - North East,Darebin - North,209021205,Kingsbury,446,433,479,1358
2021,Victoria,Melbourne - North East,Darebin - North,209021428,Preston - East,1072,975,855,2902
2021,Victoria,Melbourne - North East,Darebin - North,209021429,Preston - West,748,737,723,2208
2021,Victoria,Melbourne - North East,Darebin - North,209021523,Reservoir - North East,968,694,566,2228
2021,Victoria,Melbourne - North East,Darebin - North,209021524,Reservoir - North West,560,470,467,1497
2021,Victoria,Melbourne - North East,Darebin - North,209021525,Reservoir - South East,715,628,565,1908
2021,Victoria,Melbourne - North East,Darebin - North,209021526,Reservoir - South West,940,838,737,2515
2021,Victoria,Melbourne - North East,Nillumbik - Kinglake,209031209,Eltham,1279,1511,1772,4562
2021,Victoria,Melbourne - North East,Nillumbik - Kinglake,209031210,Hurstbridge,213,230,275,718
2021,Victoria,Melbourne - North East,Nillumbik - Kinglake,209031211,Kinglake,234,260,286,780
2021,Victoria,Melbourne - North East,Nillumbik - Kinglake,209031212,Panton Hill - St Andrews,198,257,365,820
2021,Victoria,Melbourne - North East,Nillumbik - Kinglake,209031213,Plenty - Yarrambat,439,568,724,1731
2021,Victoria,Melbourne - North East,Nillumbik - Kinglake,209031214,Research - North Warrandyte,347,462,528,1337
2021,Victoria,Melbourne - North East,Nillumbik - Kinglake,209031215,Wattle Glen - Diamond Creek,862,954,1009,2825
2021,Victoria,Melbourne - North East,Whittlesea - Wallan,209041216,Bundoora - North,325,356,427,1108
2021,Victoria,Melbourne - North East,Whittlesea - Wallan,209041217,Bundoora - West,318,280,235,833
2021,Victoria,Melbourne - North East,Whittlesea - Wallan,209041220,Mill Park - North,871,915,942,2728
2021,Victoria,Melbourne - North East,Whittlesea - Wallan,209041221,Mill Park - South,586,648,570,1804
2021,Victoria,Melbourne - North East,Whittlesea - Wallan,209041223,Thomastown,1129,1046,997,3172
2021,Victoria,Melbourne - North East,Whittlesea - Wallan,209041224,Wallan,2133,1908,1671,5712
2021,Victoria,Melbourne - North East,Whittlesea - Wallan,209041225,Whittlesea,700,718,726,2144
2021,Victoria,Melbourne - North East,Whittlesea - Wallan,209041431,Epping - East,806,846,850,2502
2021,Victoria,Melbourne - North East,Whittlesea - Wallan,209041432,Epping - South,460,455,420,1335
2021,Victoria,Melbourne - North East,Whittlesea - Wallan,209041433,Epping (Vic.) - West,1038,1255,984,3277
2021,Victoria,Melbourne - North East,Whittlesea - Wallan,209041435,South Morang - North,849,1055,1137,3041
2021,Victoria,Melbourne - North East,Whittlesea - Wallan,209041436,South Morang - South,717,776,817,2310
2021,Victoria,Melbourne - North East,Whittlesea - Wallan,209041437,Wollert,2948,2599,1707,7254
2021,Victoria,Melbourne - North East,Whittlesea - Wallan,209041527,Doreen - North,1260,1634,1571,4465
2021,Victoria,Melbourne - North East,Whittlesea - Wallan,209041528,Doreen - South,1131,1077,736,2944
2021,Victoria,Melbourne - North East,Whittlesea - Wallan,209041529,Lalor - East,584,561,494,1639
2021,Victoria,Melbourne - North East,Whittlesea - Wallan,209041530,Lalor - West,954,965,827,2746
2021,Victoria,Melbourne - North East,Whittlesea - Wallan,209041531,Mernda - North,1080,1118,872,3070
2021,Victoria,Melbourne - North East,Whittlesea - Wallan,209041532,Mernda - South,1214,1283,867,3364
2021,Victoria,Melbourne - North West,Keilor,210011226,Airport West,555,459,368,1382
2021,Victoria,Melbourne - North West,Keilor,210011227,Essendon Airport,0,0,0,0
2021,Victoria,Melbourne - North West,Keilor,210011228,Keilor,435,476,533,1444
2021,Victoria,Melbourne - North West,Keilor,210011230,Niddrie - Essendon West,410,442,505,1357
2021,Victoria,Melbourne - North West,Keilor,210011231,Strathmore,414,665,849,1928
2021,Victoria,Melbourne - North West,Keilor,210011533,Avondale Heights,652,715,648,2015
2021,Victoria,Melbourne - North West,Keilor,210011534,Keilor East,828,923,946,2697
2021,Victoria,Melbourne - North West,Macedon Ranges,210021232,Gisborne,919,1183,1143,3245
2021,Victoria,Melbourne - North West,Macedon Ranges,210021233,Macedon,195,259,298,752
2021,Victoria,Melbourne - North West,Macedon Ranges,210021234,Riddells Creek,230,284,368,882
2021,Victoria,Melbourne - North West,Macedon Ranges,210021235,Romsey,693,766,691,2150
2021,Victoria,Melbourne - North West,Moreland - North,210031236,Coburg North,566,537,421,1524
2021,Victoria,Melbourne - North West,Moreland - North,210031237,Fawkner,1091,1087,863,3041
2021,Victoria,Melbourne - North West,Moreland - North,210031439,Gowanbrae,178,207,230,615
2021,Victoria,Melbourne - North West,Moreland - North,210031440,Hadfield,472,399,341,1212
2021,Victoria,Melbourne - North West,Moreland - North,210031535,Glenroy - East,1115,856,748,2719
2021,Victoria,Melbourne - North West,Moreland - North,210031536,Glenroy - West,644,466,357,1467
2021,Victoria,Melbourne - North West,Moreland - North,210031537,Oak Park,525,451,375,1351
2021,Victoria,Melbourne - North West,Moreland - North,210031538,Pascoe Vale,1094,1036,934,3064
2021,Victoria,Melbourne - North West,Sunbury,210041240,Sunbury,786,943,957,2686
2021,Victoria,Melbourne - North West,Sunbury,210041539,Diggers Rest,520,374,248,1142
2021,Victoria,Melbourne - North West,Sunbury,210041540,Sunbury - South,885,1002,952,2839
2021,Victoria,Melbourne - North West,Sunbury,210041541,Sunbury - West,782,732,705,2219
2021,Victoria,Melbourne - North West,Tullamarine - Broadmeadows,210051242,Broadmeadows,1035,928,886,2849
2021,Victoria,Melbourne - North West,Tullamarine - Broadmeadows,210051243,Campbellfield - Coolaroo,1124,1254,1185,3563
2021,Victoria,Melbourne - North West,Tullamarine - Broadmeadows,210051245,Gladstone Park - Westmeadows,1040,1018,1058,3116
2021,Victoria,Melbourne - North West,Tullamarine - Broadmeadows,210051246,Greenvale - Bulla,1612,1590,1562,4764
2021,Victoria,Melbourne - North West,Tullamarine - Broadmeadows,210051247,Meadow Heights,1037,1121,1116,3274
2021,Victoria,Melbourne - North West,Tullamarine - Broadmeadows,210051248,Melbourne Airport,4,6,5,15
2021,Victoria,Melbourne - North West,Tullamarine - Broadmeadows,210051250,Tullamarine,387,330,297,1014
2021,Victoria,Melbourne - North West,Tullamarine - Broadmeadows,210051441,Craigieburn - Central,564,598,584,1746
2021,Victoria,Melbourne - North West,Tullamarine - Broadmeadows,210051442,Craigieburn - North,944,1176,1092,3212
2021,Victoria,Melbourne - North West,Tullamarine - Broadmeadows,210051443,Craigieburn - South,1941,1924,1622,5487
2021,Victoria,Melbourne - North West,Tullamarine - Broadmeadows,210051445,Mickleham - Yuroke,3218,2282,1426,6926
2021,Victoria,Melbourne - North West,Tullamarine - Broadmeadows,210051542,Craigieburn - North West,1207,1115,743,3065
2021,Victoria,Melbourne - North West,Tullamarine - Broadmeadows,210051543,Craigieburn - West,1209,1314,1009,3532
2021,Victoria,Melbourne - North West,Tullamarine - Broadmeadows,210051544,Roxburgh Park (South) - Somerton,530,629,727,1886
2021,Victoria,Melbourne - North West,Tullamarine - Broadmeadows,210051545,Roxburgh Park - North,1104,1287,1391,3782
2021,Victoria,Melbourne - Outer East,Knox,211011251,Bayswater,758,729,634,2121
2021,Victoria,Melbourne - Outer East,Knox,211011254,Knoxfield - Scoresby,936,1082,1054,3072
2021,Victoria,Melbourne - Outer East,Knox,211011255,Lysterfield,289,417,467,1173
2021,Victoria,Melbourne - Outer East,Knox,211011256,Rowville - Central,756,884,928,2568
2021,Victoria,Melbourne - Outer East,Knox,211011257,Rowville - North,404,494,605,1503
2021,Victoria,Melbourne - Outer East,Knox,211011258,Rowville - South,506,561,661,1728
2021,Victoria,Melbourne - Outer East,Knox,211011259,Wantirna,803,973,928,2704
2021,Victoria,Melbourne - Outer East,Knox,211011260,Wantirna South,766,952,996,2714
2021,Victoria,Melbourne - Outer East,Knox,211011446,Boronia,1459,1358,1242,4059
2021,Victoria,Melbourne - Outer East,Knox,211011447,Ferntree Gully - North,839,850,781,2470
2021,Victoria,Melbourne - Outer East,Knox,211011448,Ferntree Gully (South) - Upper Ferntree Gully,937,936,894,2767
2021,Victoria,Melbourne - Outer East,Knox,211011449,The Basin,267,316,300,883
2021,Victoria,Melbourne - Outer East,Manningham - East,211021261,Donvale - Park Orchards,670,1008,1166,2844
2021,Victoria,Melbourne - Outer East,Manningham - East,211021262,Warrandyte - Wonga Park,377,546,798,1721
2021,Victoria,Melbourne - Outer East,Maroondah,211031263,Bayswater North,719,753,719,2191
2021,Victoria,Melbourne - Outer East,Maroondah,211031265,Croydon Hills - Warranwood,942,1218,1253,3413
2021,Victoria,Melbourne - Outer East,Maroondah,211031266,Ringwood,1177,1074,993,3244
2021,Victoria,Melbourne - Outer East,Maroondah,211031267,Ringwood East,1326,1446,1355,4127
2021,Victoria,Melbourne - Outer East,Maroondah,211031268,Ringwood North,482,627,711,1820
2021,Victoria,Melbourne - Outer East,Maroondah,211031450,Croydon - East,1134,998,818,2950
2021,Victoria,Melbourne - Outer East,Maroondah,211031451,Croydon - West,891,864,847,2602
2021,Victoria,Melbourne - Outer East,Maroondah,211031452,Croydon South,333,365,313,1011
2021,Victoria,Melbourne - Outer East,Whitehorse - East,211041269,Forest Hill,563,642,595,1800
2021,Victoria,Melbourne - Outer East,Whitehorse - East,211041270,Mitcham (Vic.),1007,1052,968,3027
2021,Victoria,Melbourne - Outer East,Whitehorse - East,211041271,Nunawading,764,766,697,2227
2021,Victoria,Melbourne - Outer East,Whitehorse - East,211041272,Vermont,580,884,856,2320
2021,Victoria,Melbourne - Outer East,Whitehorse - East,211041273,Vermont South,471,630,715,1816
2021,Victoria,Melbourne - Outer East,Yarra Ranges,211051274,Belgrave - Selby,568,649,727,1944
2021,Victoria,Melbourne - Outer East,Yarra Ranges,211051275,Chirnside Park,833,793,729,2355
2021,Victoria,Melbourne - Outer East,Yarra Ranges,211051276,Healesville - Yarra Glen,753,837,862,2452
2021,Victoria,Melbourne - Outer East,Yarra Ranges,211051277,Kilsyth,701,608,566,1875
2021,Victoria,Melbourne - Outer East,Yarra Ranges,211051278,Lilydale - Coldstream,1154,1081,1261,3496
2021,Victoria,Melbourne - Outer East,Yarra Ranges,211051279,Monbulk - Silvan,302,410,398,1110
2021,Victoria,Melbourne - Outer East,Yarra Ranges,211051280,Montrose,465,480,456,1401
2021,Victoria,Melbourne - Outer East,Yarra Ranges,211051281,Mooroolbark,1606,1573,1521,4700
2021,Victoria,Melbourne - Outer East,Yarra Ranges,211051282,Mount Dandenong - Olinda,458,624,653,1735
2021,Victoria,Melbourne - Outer East,Yarra Ranges,211051283,Mount Evelyn,683,706,605,1994
2021,Victoria,Melbourne - Outer East,Yarra Ranges,211051284,Upwey - Tecoma,580,642,655,1877
2021,Victoria,Melbourne - Outer East,Yarra Ranges,211051285,Wandin - Seville,487,513,533,1533
2021,Victoria,Melbourne - Outer East,Yarra Ranges,211051286,Yarra Valley,952,994,1132,3078
2021,Victoria,Melbourne - South East,Cardinia,212011289,Emerald - Cockatoo,1091,1294,1416,3801
2021,Victoria,Melbourne - South East,Cardinia,212011546,Beaconsfield - Officer,2099,1848,1635,5582
2021,Victoria,Melbourne - South East,Cardinia,212011547,Bunyip - Garfield,583,647,753,1983
2021,Victoria,Melbourne - South East,Cardinia,212011548,Koo Wee Rup,753,731,668,2152
2021,Victoria,Melbourne - South East,Cardinia,212011549,Pakenham - North East,1445,1302,1039,3786
2021,Victoria,Melbourne - South East,Cardinia,212011550,Pakenham - North West,757,738,475,1970
2021,Victoria,Melbourne - South East,Cardinia,212011551,Pakenham - South East,451,429,291,1171
2021,Victoria,Melbourne - South East,Cardinia,212011552,Pakenham - South West,2197,2499,2243,6939
2021,Victoria,Melbourne - South East,Casey - North,212021293,Berwick - North,1087,1352,1457,3896
2021,Victoria,Melbourne - South East,Casey - North,212021295,Doveton,928,720,737,2385
2021,Victoria,Melbourne - South East,Casey - North,212021297,Hallam,805,756,765,2326
2021,Victoria,Melbourne - South East,Casey - North,212021299,Narre Warren North,357,518,617,1492
2021,Victoria,Melbourne - South East,Casey - North,212021453,Endeavour Hills - North,661,697,753,2111
2021,Victoria,Melbourne - South East,Casey - North,212021454,Endeavour Hills - South,778,857,807,2442
2021,Victoria,Melbourne - South East,Casey - North,212021455,Narre Warren - North East,846,927,881,2654
2021,Victoria,Melbourne - South East,Casey - North,212021456,Narre Warren - South West,1069,956,896,2921
2021,Victoria,Melbourne - South East,Casey - North,212021553,Berwick - South East,1043,1554,1727,4324
2021,Victoria,Melbourne - South East,Casey - North,212021554,Berwick - South West,894,1041,929,2864
2021,Victoria,Melbourne - South East,Casey - South,212031300,Cranbourne,1560,1531,1310,4401
2021,Victoria,Melbourne - South East,Casey - South,212031303,Cranbourne South,1771,1487,1056,4314
2021,Victoria,Melbourne - South East,Casey - South,212031304,Cranbourne West,2247,2068,1525,5840
2021,Victoria,Melbourne - South East,Casey - South,212031306,Lynbrook - Lyndhurst,1494,1675,1526,4695
2021,Victoria,Melbourne - South East,Casey - South,212031308,Pearcedale - Tooradin,484,532,534,1550
2021,Victoria,Melbourne - South East,Casey - South,212031457,Narre Warren South - East,677,924,1200,2801
2021,Victoria,Melbourne - South East,Casey - South,212031458,Narre Warren South - West,1154,1258,1472,3884
2021,Victoria,Melbourne - South East,Casey - South,212031555,Clyde North - North,1052,1151,953,3156
2021,Victoria,Melbourne - South East,Casey - South,212031556,Clyde North - South,1975,1535,937,4447
2021,Victoria,Melbourne - South East,Casey - South,212031557,Cranbourne East - North,2241,2369,1990,6600
2021,Victoria,Melbourne - South East,Casey - South,212031558,Cranbourne East - South,1479,1101,788,3368
2021,Victoria,Melbourne - South East,Casey - South,212031559,Cranbourne North - East,1217,1382,1226,3825
2021,Victoria,Melbourne - South East,Casey - South,212031560,Cranbourne North - West,902,965,919,2786
2021,Victoria,Melbourne - South East,Casey - South,212031561,Hampton Park - East,965,958,940,2863
2021,Victoria,Melbourne - South East,Casey - South,212031562,Hampton Park - West,951,949,953,2853
2021,Victoria,Melbourne - South East,Dandenong,212041309,Clarinda - Oakleigh South,573,611,583,1767
2021,Victoria,Melbourne - South East,Dandenong,212041310,Clayton South,775,623,517,1915
2021,Victoria,Melbourne - South East,Dandenong,212041312,Dandenong North,1368,1343,1324,4035
2021,Victoria,Melbourne - South East,Dandenong,212041313,Dingley Village,493,627,769,1889
2021,Victoria,Melbourne - South East,Dandenong,212041316,Noble Park North,421,444,425,1290
2021,Victoria,Melbourne - South East,Dandenong,212041317,Springvale,1215,1135,934,3284
2021,Victoria,Melbourne - South East,Dandenong,212041318,Springvale South,634,751,736,2121
2021,Victoria,Melbourne - South East,Dandenong,212041459,Noble Park - East,931,659,511,2101
2021,Victoria,Melbourne - South East,Dandenong,212041460,Noble Park - West,1200,1121,933,3254
2021,Victoria,Melbourne - South East,Dandenong,212041563,Dandenong - North,1468,1219,1069,3756
2021,Victoria,Melbourne - South East,Dandenong,212041564,Dandenong - South,717,718,653,2088
2021,Victoria,Melbourne - South East,Dandenong,212041565,Keysborough - North,814,863,904,2581
2021,Victoria,Melbourne - South East,Dandenong,212041566,Keysborough - South,1138,1217,1105,3460
2021,Victoria,Melbourne - South East,Monash,212051319,Ashwood - Chadstone,1114,1092,1106,3312
2021,Victoria,Melbourne - South East,Monash,212051321,Glen Waverley - East,841,1367,1546,3754
2021,Victoria,Melbourne - South East,Monash,212051322,Glen Waverley - West,851,1240,1430,3521
2021,Victoria,Melbourne - South East,Monash,212051323,Mount Waverley - North,670,952,1144,2766
2021,Victoria,Melbourne - South East,Monash,212051324,Mount Waverley - South,926,1219,1216,3361
2021,Victoria,Melbourne - South East,Monash,212051325,Mulgrave,1112,1257,1206,3575
2021,Victoria,Melbourne - South East,Monash,212051326,Oakleigh - Huntingdale,1329,1250,1153,3732
2021,Victoria,Melbourne - South East,Monash,212051327,Wheelers Hill,712,1122,1262,3096
2021,Victoria,Melbourne - South East,Monash,212051567,Clayton (North) - Notting Hill,266,250,178,694
2021,Victoria,Melbourne - South East,Monash,212051568,Clayton - Central,568,417,319,1304
2021,Victoria,Melbourne - West,Brimbank,213011328,Ardeer - Albion,471,414,281,1166
2021,Victoria,Melbourne - West,Brimbank,213011329,Cairnlea,528,735,721,1984
2021,Victoria,Melbourne - West,Brimbank,213011331,Delahey,453,430,428,1311
2021,Victoria,Melbourne - West,Brimbank,213011332,Keilor Downs,695,727,703,2125
2021,Victoria,Melbourne - West,Brimbank,213011333,Kings Park (Vic.),849,938,862,2649
2021,Victoria,Melbourne - West,Brimbank,213011334,St Albans - North,1272,1230,1066,3568
2021,Victoria,Melbourne - West,Brimbank,213011335,St Albans - South,938,938,904,2780
2021,Victoria,Melbourne - West,Brimbank,213011336,Sunshine,604,517,451,1572
2021,Victoria,Melbourne - West,Brimbank,213011337,Sunshine North,710,666,662,2038
2021,Victoria,Melbourne - West,Brimbank,213011338,Sunshine West,1067,1076,1012,3155
2021,Victoria,Melbourne - West,Brimbank,213011339,Sydenham,667,672,676,2015
2021,Victoria,Melbourne - West,Brimbank,213011340,Taylors Lakes,664,798,970,2432
2021,Victoria,Melbourne - West,Brimbank,213011569,Deer Park,1237,1361,1151,3749
2021,Victoria,Melbourne - West,Brimbank,213011570,Derrimut,735,941,807,2483
2021,Victoria,Melbourne - West,Hobsons Bay,213021341,Altona,817,887,743,2447
2021,Victoria,Melbourne - West,Hobsons Bay,213021342,Altona Meadows,1137,1015,929,3081
2021,Victoria,Melbourne - West,Hobsons Bay,213021343,Altona North,1177,988,783,2948
2021,Victoria,Melbourne - West,Hobsons Bay,213021344,Newport,1511,1368,1229,4108
2021,Victoria,Melbourne - West,Hobsons Bay,213021345,Seabrook,329,405,331,1065
2021,Victoria,Melbourne - West,Hobsons Bay,213021346,Williamstown,666,977,1228,2871
2021,Victoria,Melbourne - West,Maribyrnong,213031347,Braybrook,1090,1012,956,3058
2021,Victoria,Melbourne - West,Maribyrnong,213031348,Footscray,831,609,426,1866
2021,Victoria,Melbourne - West,Maribyrnong,213031349,Maribyrnong,637,531,587,1755
2021,Victoria,Melbourne - West,Maribyrnong,213031350,Seddon - Kingsville,673,615,515,1803
2021,Victoria,Melbourne - West,Maribyrnong,213031351,West Footscray - Tottenham,789,732,529,2050
2021,Victoria,Melbourne - West,Maribyrnong,213031352,Yarraville,1062,1035,917,3014
2021,Victoria,Melbourne - West,Melton - Bacchus Marsh,213041353,Bacchus Marsh,1689,1796,1797,5282
2021,Victoria,Melbourne - West,Melton - Bacchus Marsh,213041358,Melton West,1817,1956,1780,5553
2021,Victoria,Melbourne - West,Melton - Bacchus Marsh,213041359,Rockbank - Mount Cottrell,1937,1544,911,4392
2021,Victoria,Melbourne - West,Melton - Bacchus Marsh,213041360,Taylors Hill,1192,1801,2075,5068
2021,Victoria,Melbourne - West,Melton - Bacchus Marsh,213041461,Burnside,354,434,429,1217
2021,Victoria,Melbourne - West,Melton - Bacchus Marsh,213041462,Burnside Heights,474,776,631,1881
2021,Victoria,Melbourne - West,Melton - Bacchus Marsh,213041463,Caroline Springs,1273,1568,1834,4675
2021,Victoria,Melbourne - West,Melton - Bacchus Marsh,213041571,Brookfield,867,972,788,2627
2021,Victoria,Melbourne - West,Melton - Bacchus Marsh,213041572,Cobblebank - Strathtulloh,1072,806,483,2361
2021,Victoria,Melbourne - West,Melton - Bacchus Marsh,213041573,Eynesbury - Exford,280,320,287,887
2021,Victoria,Melbourne - West,Melton - Bacchus Marsh,213041574,Fraser Rise - Plumpton,1144,890,800,2834
2021,Victoria,Melbourne - West,Melton - Bacchus Marsh,213041575,Hillside,878,1071,1294,3243
2021,Victoria,Melbourne - West,Melton - Bacchus Marsh,213041576,Kurunjang - Toolern Vale,856,893,869,2618
2021,Victoria,Melbourne - West,Melton - Bacchus Marsh,213041577,Melton,521,546,459,1526
2021,Victoria,Melbourne - West,Melton - Bacchus Marsh,213041578,Melton South - Weir Views,1714,1625,1218,4557
2021,Victoria,Melbourne - West,Wyndham,213051361,Hoppers Crossing - North,1127,1207,1165,3499
2021,Victoria,Melbourne - West,Wyndham,213051362,Hoppers Crossing - South,1128,1396,1204,3728
2021,Victoria,Melbourne - West,Wyndham,213051363,Laverton,967,805,572,2344
2021,Victoria,Melbourne - West,Wyndham,213051368,Werribee - South,1091,1111,1034,3236
2021,Victoria,Melbourne - West,Wyndham,213051464,Point Cook - East,1762,2004,1610,5376
2021,Victoria,Melbourne - West,Wyndham,213051466,Point Cook - South,1944,2603,1715,6262
2021,Victoria,Melbourne - West,Wyndham,213051467,Werribee - East,1293,1262,1227,3782
2021,Victoria,Melbourne - West,Wyndham,213051468,Werribee - West,2143,1737,1404,5284
2021,Victoria,Melbourne - West,Wyndham,213051579,Manor Lakes - Quandong,1209,1184,899,3292
2021,Victoria,Melbourne - West,Wyndham,213051580,Point Cook - North East,887,1101,1279,3267
2021,Victoria,Melbourne - West,Wyndham,213051581,Point Cook - North West,767,938,792,2497
2021,Victoria,Melbourne - West,Wyndham,213051582,Tarneit (West) - Mount Cottrell,1430,1104,706,3240
2021,Victoria,Melbourne - West,Wyndham,213051583,Tarneit - Central,2743,2958,2362,8063
2021,Victoria,Melbourne - West,Wyndham,213051584,Tarneit - North,1003,734,441,2178
2021,Victoria,Melbourne - West,Wyndham,213051585,Tarneit - South,1088,1179,979,3246
2021,Victoria,Melbourne - West,Wyndham,213051586,Truganina - North,1095,821,476,2392
2021,Victoria,Melbourne - West,Wyndham,213051587,Truganina - South East,1199,1041,578,2818
2021,Victoria,Melbourne - West,Wyndham,213051588,Truganina - South West,2185,2230,1604,6019
2021,Victoria,Melbourne - West,Wyndham,213051589,Wyndham Vale - North,1039,838,598,2475
2021,Victoria,Melbourne - West,Wyndham,213051590,Wyndham Vale - South,1101,1226,1071,3398
